abcdefghijklmnopqrstuvwxyz
a b c c c c c c c a a a a a c c c c a a a a a a a c c c c c c c c c c c c c c c c c c c c c c c c c c c c c c c c c c c c a a a a a 
a b a a c c c a a a a a a c c c c c c a a a a a a a a a a a a a c c c c c c c c c c c c c c c c c c c c c c c c c c c c a a a a a a
a b a a c c c a a a a a a a c c c c a a a a a a a a a a a a a a c c c c c c c c c c c c c a a c c c c c c c c c c c c c a a a a a a
a b a a c c c c c a a a a a a c a a a a a a a a a a a a a a a a c c c c c c c c c c c c c a a c c c c c c c c c c c c c a c a c a a
a b a c c c c c c a a c c a a c a a a a a a a a a a c c c a a c c c c c c c c c c c c c a a a c c c c c c c c c c c c c c c c c a a
a b c c c c c c c a a a a c c c a a a a a a a a a c c c c c c c c c c c c c a a a c c c a a a c c c c c c c c c c c c c c c c c a a
a b c c c c c c c c a a a c c c c c c c c a a a a c c c c c c c c c c c c c a a a a a c a a a c c a c a c c c c c c c c c c c c c c
a b c c c c c c c c a a a c a a a c c c c c a a a c c c c c c c c c c c c c a a a a a a a j j j j j k k k c c c c c a a c c c c c c 
a b c c c c c a a a a a a a a a a c c c c c a a c c c c c c c c c c c i i i i i i j j j j j j j j j k k k c a a a a a a c c c c c c
a b c c c c c a a a a a a a a a c c c c c c c c c c c c c c c c c c i i i i i i i j j j j j j j r r k k k k a a a a a a a a c c c c
a b c c c c c c c a a a a a c c c c c c c c c c c c c c c c c c c i i i i i i i i j j j j r r r r r p p k k k a a a a a a a c c c c
a b c c c a a c c a a a a a a c c c c c c c c c c c a a c a a c i i i i q q q q q r r r r r r r r p p p k k k a a a a a a a c c c c
a b c c a a a a a a a a a a a a c c c c a c c c c c a a a a a c i i i q q q q q q r r r r r r u u p p p p k k a a a a a c c c c c c
a b c c c a a a a a a a c a a a a c a a a c c c c c a a a a a a h i i q q q q t t t r r r u u u u u p p p k k a a a a a c c c c c c
a b c a a a a a a a c c c c a a a a a a a c c c c c a a a a a a h h q q q t t t t t u u u u u u u u u p p k k k c c a a c c c c c c
a b c a a a a a a a a c c c c a a a a a a c c c c c a a a a a a h h q q q t t t t t u u u u x x u u u p p k k l c c c c c c c c c c
a b c a a a a a a a a c a a a a a a a a a a a c c c c c a a a c h h h q q t t t x x x u u x x y y u u p p l l l l c c c c c c c c c
a b c c c a a a c a c c a a a a a a a a a a a c c c c c c c c c h h h q q t t t x x x x x x x y u u p p p p l l l c c c c c c c c c 
a b a a c a a c c c c c a a a a a a a a a a a c c c c c c c c c h h h q q t t t x x x x x x y y v v v p p p p l l l c c c c c c c c 
a b a a c c c c c c c c c a a a a a a a c c c c c c c c c c c c h h h p p p t t x x x x x y y y v v v v p q q q l l l c c c c c c c 
S b a a c c c c c c a a a a a a a a a a c c c c c c c c c c c h h h p p p t t t x x x E z z y y y y v v v q q q l l l c c c c c c c 
a b a a a a c c c c a a a a a a a a a c c c c c c c c c c c c h h h p p p s s s x x x y y y y y y y y v v v q q q l l l c c c c c c
a b a a a a c c c c c a a a a a a a a c c c c c c c c c c c g g g p p p s s s x x y y y y y y y y y v v v v q q q l l l c c c c c c
a b a a a c c c a a a a c a a a a a a a c c c c c c c c c c g g g p p p s s w w w w w w y y y v v v v v v q q q l l l l c c c c c c
a b a a c c c c a a a a c a a c c a a a a c c c c c c c c c g g g p p s s s w w w w w w y y y w v v v v q q q q m m m c c c c c c c
a b a a c c c c a a a a c a a c c a a a a c c a a a c c c c g g p p p s s s s s w w s w w y y w v q q q q q q m m m m c c c c c c c
a b c c c c c c c a a a c c c c c a a a c c c a a a c a c c g g g p p p s s s s s s s w w w w w w r q q m m m m m c c c c c c c c c
a b c c c c c c c c c c c c c c c c c c c a a c a a a a a c g g g p p o o o s s s s s r w w w w r r r m m m m m c c c c c c c c c c
a b c c c c c c c c c c c c c c c c c c c a a a a a a a a c g g g g o o o o o o o o r r r w w w r r n m m m d d d c c a a c c c c c
a b a c c c c c c c c c c c c a a c c c c c a a a a a c c c c g g g g o o o o o o o o r r r r r r r n m m d d d d c a a a c c c c c
a b a c c c c c c c c a a a a a a c c c c c c a a a a a c c c c g g f f f f f o o o o o r r r r r n n n d d d d d a a a a c c c c c
a b a a c c c c c c c a a a a a a c c c c c a a a a a a c c c c c f f f f f f f f o o n r r r r r n n n d d d a a a a a a a c c c c
a b a a c c c c c c c c a a a a a a a c c a c a a a a c c c c c c c c c f f f f f f o n n n n n n n n d d d a a a a a a a a c c c c
a b c c c c c c c c c c a a a a a a a a a a a a a a a c c c c c c c c c c c c f f f e n n n n n n n d d d d c c a a a c c c c c c c
a b c c c c c c c c c a a a a a a a c a a a a a a a a a a c c c c c c c c c c c f f e e n n n n n e d d d c c c c a a c c c c c c c
a b c c c c c c c c c a a a a a a c c a a a a a a a a a a a c c c c c c c c c c a e e e e e e e e e e d c c c c c c c c c c c c c c
a b c c c c c c c c c c c c a a a c c a a a a a a a a a a a c c c c c c c c c c a a a e e e e e e e e c c c c c c c c c c c c c a a
a b c c c c c c c a a c c c c c c c c a a a a a a a a c c c c c c c c c c c c c a a a c e e e e e c c c c c c c c c c c c c c c a a
a b a a c c a a a a a a c c c c c c c c a a a a a a a a c c c c c c c c c c c c c a c c c c a a a c c c c c c c c c c c a a a c a a
a b a a c c a a a a a c c c c c a a a a a a a a a a a c c c c c c c c c c c c c c c c c c c c c a c c c c c c c c c c c a a a a a a
a b a c c a a a a a a a a c c a a a a a a a a a a a a a a c c c c c c c c c c c c c c c c c c c c c c c c c c c c c c c a a a a a a